     19 zxjfd3audtkrbbiabg54lghcrlaxhqurpgjgh2maegjosq1eibik2uhaevubty5kqmmxc0rpyoverq	dmgm9ejc
     10 dmgm9ejc	zxjfd3audtkrbbiabg54lghcrlaxhqurpgjgh2maegjosq1eibik2uhaevubty5kqmmxc0rpyoverq
      6 w	polsce
      5 relpreconnect	link
      5 link	relpreconnect
      5 jerzy	hausner
      5 ifbxyqbw1mmguhfiofbwyybqcwkgvtzjifbxyqbw1mmguhfiofbwyybqcwkgvtzjifbxyqbw1mmguhfi	ofbwyybqcwkgvtzjifbxyqbw1mmguhfiofbwyybqcwkgvtzjifbxyqbw1mmguhfiofbwyybqcwkgvtzj
      5 ale	nie
      4 ufcg4zezirjquibjmtmhelbqhumxmyesufcg4zezirjquibjmtmhelbqhumxmyesufcg4zezirjquibj	mtmhelbqhumxmyesufcg4zezirjquibjmtmhelbqhumxmyesufcg4zezirjquibjmtmhelbqhumxmyes
      4 u9cgyqezirjt0iziotmhelpqhmkhmyesu9cgyqezirjt0iziotmhelpqhmkhmyesu9cgyqezirjt0izi	otmhelpqhmkhmyesu9cgyqezirjt0iziotmhelpqhmkhmyesu9cgyqezirjt0iziotmhelpqhmkhmyes
      4 otmhelpqhmkhmyesu9cgyqezirjt0iziotmhelpqhmkhmyesu9cgyqezirjt0iziotmhelpqhmkhmyes	u9cgyqezirjt0iziotmhelpqhmkhmyesu9cgyqezirjt0iziotmhelpqhmkhmyesu9cgyqezirjt0izi
      4 ofbzqqpbgokguhnco8gcgqbqc0kjwykcofbzqqpbgokguhnco8gcgqbqc0kjwykcofbzqqpbgokguhnc	o8gcgqbqc0kjwykcofbzqqpbgokguhnco8gcgqbqc0kjwykcofbzqqpbgokguhnco8gcgqbqc0kjwykc
      4 ofbwyybqcwkgvtzjifbxyqbw1mmguhfiofbwyybqcwkgvtzjifbxyqbw1mmguhfiofbwyybqcwkgvtzj	ifbxyqbw1mmguhfiofbwyybqcwkgvtzjifbxyqbw1mmguhfiofbwyybqcwkgvtzjifbxyqbw1mmguhfi
      4 o8gcgqbqc0kjwykcofbzqqpbgokguhnco8gcgqbqc0kjwykcofbzqqpbgokguhnco8gcgqbqc0kjwykc	ofbzqqpbgokguhnco8gcgqbqc0kjwykcofbzqqpbgokguhnco8gcgqbqc0kjwykcofbzqqpbgokguhnc
      4 mtmhelbqhumxmyesufcg4zezirjquibjmtmhelbqhumxmyesufcg4zezirjquibjmtmhelbqhumxmyes	ufcg4zezirjquibjmtmhelbqhumxmyesufcg4zezirjquibjmtmhelbqhumxmyesufcg4zezirjquibj
      4 co	się
      4 2026	roku
      3 że	to
      3 w	tym
      3 to	jest
      3 relpreload	asstyle
      3 relpreload	asscript
      3 nie	widzi
      3 krzysztof	janoś
      3 grzechów	głównych
